2020202020202020
2020202020202320
2020212020222020
2020202020202020
2020202020202320
2020212020222020